11111111111111111111111111111111111111111111111111
10000000000000000000000000000000000000000000000001
10000000000000000000000000000000000000000000000001
10000K00000000000000000000000000000000000000000001
10001111000000000000000000011111000000000000000001
10000000000001111000000000000000000000000000000001
11000000000000000000000000000000000000000000000001
10000000011110000000111100000000001111000000000D01
11111111111111111111111111111111111111111111111111
