111111111111111111111111111111
100000000000000000000000000001
100000000000000000000000000001
100000000000000000000000000001
100K00000000000000000000000001
111110000000000000000000000001
100000000000000000000000000001
100000000000000000000000000001
100000000000000000000000000001
100000000000000000000000000001
100000000000000000000000000001
111111111111111100000000000001
100000000000000000000000000001
1000000000000000000000000000G1
111111111111111111111111111111